Атрибуты датасета

school - школа ( тип данных - бинарный. Принимает значения: 'GP' - Gabriel Pereira или 'MS' - Mousinho da Silveira)
sex - пол ( тип данных - бинарный. Принимает значения: 'F' - женский или 'M' - мужской)
age - возраст ( тип данных - числовой. Принимает значения: от 15 до 22)
address - тип проживания ( тип данных - бинарный: 'U' - городской или 'R' - сельский)
famsize - размер семьи ( тип данных - бинарный. Принимает значения: 'LE3' - меньше или равно 3 или 'GT3' - больше 3)
Pstatus - тип проживания родителей ( тип данных - бинарный. Принимает значения: 'T' - живут вместе или 'A' - раздельно)
Medu - образование матери ( тип данных - числовой. Принимает значения: 0 - нет, 1 - начальная школа, 2 – неполное среднее образование, 3 – среднее образование или 4 – высшее образование)
Fedu - образование отца ( тип данных - числовой. Принимает значения: 0 - нет, 1 - начальная школа , 2 – неполное среднее образование, 3 – среднее образование или 4 – высшее образование)
Mjob - работа матери ( тип данных - текст (фиксированное количество вариантов). Принимает значения: 'teacher' - сфера образования, 'health' - сфера здравоохранения, 'services' - государственная/муниципальная служба, 'at_home' - домохозяйка или 'other' - другое)
Fjob - работа отца ( тип данных - текст (фиксированное количество вариантов). Принимает значения: 'teacher' - сфера образования, 'health' - сфера здравоохранения, 'services' - государственная/муниципальная служба, 'at_home' - домохозяйка или 'other' - другое)
reason - причины выбора данной школы ( тип данных - текст (фиксированное количество вариантов). Принимает значения: 'home' - близко к дому, 'reputation' - репутация школы, 'course' - интересные предметы или 'other' - другое)
guardian - опекун ( тип данных - текст (фиксированное количество вариантов). Принимает значения: 'mother', 'father' или 'other')
traveltime - время до школы ( тип данных - числовой. Принимает значения: 1 - <15 ., 2 - 15-30 мин., 3 - 30 мин. - 1 час, или 4 - больше 1 часа)
studytime - часы обучения в неделю ( тип данных - числовой. Принимает значения: 1 - меньше 2 часов, 2 - 2-5 часов, 3 - 5-10 часов, или 4 - больше 10 часов)
failures - количество несданных ранее предметов ( тип данных - числовой. Принимает значения: n, если 1<=n<3, иначе 4)
schoolsup - посещение дополнительных занятий ( тип данных - бинарный. Принимает значения: yes или no)
famsup - помощь в обучении от семьи ( тип данных - бинарный. Принимает значения: yes или no)
paid - дополнительные платные занятия ( тип данных - бинарный. Принимает значения: yes или no)
activities - посещение кружков ( тип данных - бинарный. Принимает значения: yes или no)
nursery - посещение дошкольного образовательного учреждения ( тип данных - бинарный. Принимает значения: yes или no)
higher - желание получить высшее образование ( тип данных - бинарный. Принимает значения: yes или no)
internet - наличие доступа к Интернету дома ( тип данных - бинарный. Принимает значения: yes или no)
romantic - наличие отношений ( тип данных - бинарный. Принимает значения: yes или no)
famrel - оценка отношений в семье ( тип данных - числовой. Принимает значения: от 1 - очень плохо, до 5 - великолепно)
freetime - свободное время после занятий ( тип данных - числовой. Принимает значения: от 1 - very low, до 5 - очень много)
goout - прогулки с друзьями ( тип данных - числовой. Принимает значения: от 1 - очень редко, до 5 - очень часто)
Dalc - потребление алкоголя в рабочие дни ( тип данных - числовой. Принимает значения: от 1 - очень мало, до 5 - очень много)
Walc - потребление алкоголя в выходные ( тип данных - числовой. Принимает значения: от 1 - очень мало, до 5 - очень много)
health - состояние здоровья ( тип данных - числовой. Принимает значения: от 1 - очень плохое, до 5 - отличное)
absences - количество пропусков занятий ( тип данных - числовой. Принимает значения: от 0 до 93)